xxxxxxxxxxxxxxxxxxxxxxxxxxxxxxxxxxxxxxxx
xR                                     x
x         tttth                        x
x         t                            x
x         t                            x
x                                      x
x                                      x
x                                      x
x                                      x
x                                      x
x                                      x
x                                      x
x                                      x
x                                      x
x                                      x
x                                      x
x                                      x
x                                      x
x                                      x
x                                      x
x                                      x
x                                      x
x                                      x
x                                      x
x                                      x
x      xxxxxxx                         x
x      x     x                         x
x      xxxxxxx                         x
x                                      x
xxxxxxxxxxxxxxxxxxxxxxxxxxxxxxxxxxxxxxxx